4
13 13

87	0	201	202	201	0	1	0	0	0	0	0	0
1	1	1	1	1	0	1	0	0	0	0	0	0
0	0	1	0	0	0	1	1	1	1	1	1	1
0	0	1	0	0	0	1	0	0	21	1	0	0
1	1	1	1	0	1	1	0	205	0	1	0	0
21	28	1	0	0	0	1	31	0	209	1	201	201
0	31	1	0	0	0	1	1	1	81	1	0	0
81	1	1	0	0	0	0	0	0	0	81	0	0
205	0	1	0	0	0	0	0	0	0	1	1	1
0	201	81	0	0	0	0	0	0	0	1	0	0
1	1	1	81	1	1	0	1	1	81	1	1	1
21	21	0	205	1	0	0	0	1	217	205	0	27
22	21	0	0	1	0	0	0	1	205	0	0	31


88	0	0	0	0	0	0	81	201	0	32	21	21
1	1	1	1	0	0	0	1	1	1	1	1	1
21	0	205	1	0	0	0	81	201	0	21	21	21
0	217	0	1	1	1	205	1	1	1	1	1	1
205	0	210	81	0	0	0	1	0	0	0	21	21
1	1	1	1	0	0	21	1	0	0	1	0	0
21	21	0	1	0	21	0	1	217	0	1	0	210
0	1	1	1	205	1	1	1	81	1	1	1	82
0	21	31	1	0	81	0	201	0	0	1	0	205
1	1	81	1	81	1	0	201	0	0	81	202	0
217	205	205	1	217	1	1	1	1	209	1	1	1
81	1	1	1	205	1	31	0	1	81	1	0	0
205	205	217	81	205	1	31	0	202	0	202	0	87


205	217	0	1	0	0	40	0	0	1	0	1	88
31	1	205	1	0	31	0	31	0	1	0	1	201
21	1	0	81	0	0	0	0	82	201	0	1	202
31	1	1	1	1	1	1	1	1	1	0	1	201
0	0	1	1	0	0	28	0	81	81	0	0	0
1	1	1	1	1	0	0	0	1	1	1	21	0
21	205	0	0	1	1	201	1	1	1	1	1	1
1	1	0	0	1	0	0	0	1	21	22	1	1
21	205	0	217	81	0	0	0	0	0	0	1	1
1	1	0	0	1	0	0	0	1	202	0	1	0
21	205	0	0	1	1	202	1	1	81	1	1	1
1	1	0	0	1	0	0	0	1	0	0	0	1
21	205	0	0	1	0	87	0	1	0	0	22	1


27	1	32	1	1	1	1	1	1	1	21	1	22
202	1	202	1	0	21	31	21	0	1	202	1	202
81	1	81	1	0	0	0	0	0	1	81	1	81
0	205	0	205	0	0	0	0	0	205	0	205	0
1	1	1	1	1	0	0	0	1	1	1	1	1
1	0	0	0	1	0	0	0	1	0	0	0	1
299	0	0	209	81	0	0	0	1	0	0	0	0
1	0	0	0	1	0	0	0	1	0	0	0	1
1	1	1	1	1	0	0	0	1	1	1	1	1
22	0	0	205	82	0	0	0	82	205	0	0	22
1	0	0	0	1	1	81	1	1	0	0	0	1
1	209	1	202	1	0	0	0	1	202	1	209	1
1	32	1	21	1	0	88	0	1	21	1	32	1


1 1 0 75 200 0 0 10 10

7
201 35 20 1 1 0
202 55 21 2 2 0
205 18 55 5 3 0
217 60 36 8 6 2
209 48 52 6 5 0
210 48 72 18 8 0
299 200 100 2 20 0

20 5 100 2 2 0

1000 10 10 0 0 0 0 0 0 12 6 
